//MAP CONVERTED BY dmm2tgm.py THIS HEADER COMMENT PREVENTS RECONVERSION, DO NOT REMOVE
"aa" = (
/turf/template_noop,
/area/template_noop)
"ab" = (
/turf/closed/wall/mineral/titanium/nodiagonal,
/area/ruin/powered/golem_ship)
"af" = (
/turf/open/floor/plating,
/area/ruin/powered/golem_ship)
"ag" = (
/obj/structure/reagent_dispensers/fueltank,
/obj/effect/turf_decal/bot,
/turf/open/floor/plasteel/dark,
/area/ruin/powered/golem_ship)
"ai" = (
/obj/machinery/light/small,
/turf/open/floor/plating,
/area/ruin/powered/golem_ship)
"ak" = (
/obj/structure/shuttle/engine/heater{
	dir = 4
	},
/obj/structure/window/reinforced{
	dir = 8
	},
/turf/open/floor/plating{
	initial_gas_mix = "LAVALAND_ATMOS"
	},
/area/ruin/powered/golem_ship)
"al" = (
/turf/open/floor/mineral/titanium/purple,
/area/ruin/powered/golem_ship)
"am" = (
/obj/effect/turf_decal/bot,
/obj/structure/closet/crate,
/obj/effect/spawner/lootdrop/maintenance,
/obj/effect/decal/cleanable/dirt,
/turf/open/floor/mineral/plastitanium,
/area/ruin/powered/golem_ship)
"an" = (
/obj/structure/shuttle/engine/propulsion{
	dir = 8
	},
/turf/open/floor/plating{
	initial_gas_mix = "LAVALAND_ATMOS"
	},
/area/ruin/powered/golem_ship)
"av" = (
/obj/item/resonator/upgraded,
/turf/open/floor/mineral/titanium/purple,
/area/ruin/powered/golem_ship)
"aw" = (
/obj/machinery/autolathe,
/turf/open/floor/mineral/titanium/purple,
/area/ruin/powered/golem_ship)
"ay" = (
/obj/machinery/computer/arcade/orion_trail,
/turf/open/floor/mineral/titanium/purple,
/area/ruin/powered/golem_ship)
"aK" = (
/obj/structure/bed,
/obj/item/bedsheet/rd/royal_cape,
/turf/open/floor/plasteel/dark,
/area/ruin/powered/golem_ship)
"aO" = (
/obj/machinery/light{
	dir = 8
	},
/turf/open/floor/mineral/titanium/purple,
/area/ruin/powered/golem_ship)
"aT" = (
/obj/structure/fans/tiny,
/obj/machinery/door/airlock/titanium,
/turf/open/floor/mineral/titanium/purple,
/area/ruin/powered/golem_ship)
"bH" = (
/obj/machinery/light/small{
	dir = 1
	},
/obj/effect/decal/cleanable/dirt,
/turf/open/floor/mineral/titanium/blue,
/area/ruin/powered/golem_ship)
"bN" = (
/obj/machinery/door/airlock/titanium,
/obj/effect/mapping_helpers/airlock/cyclelink_helper{
	dir = 8
	},
/turf/open/floor/plasteel/dark,
/area/ruin/powered/golem_ship)
"bW" = (
/obj/machinery/door/airlock/titanium,
/obj/effect/decal/cleanable/dirt,
/turf/open/floor/plasteel/dark,
/area/ruin/powered/golem_ship)
"cW" = (
/obj/structure/chair/comfy/shuttle{
	dir = 8
	},
/obj/effect/decal/cleanable/dirt,
/turf/open/floor/mineral/plastitanium,
/area/ruin/powered/golem_ship)
"cZ" = (
/obj/effect/decal/cleanable/blood/tracks{
	dir = 4
	},
/turf/open/floor/mineral/titanium/yellow,
/area/ruin/powered/golem_ship)
"ec" = (
/obj/effect/turf_decal/box/corners{
	dir = 1
	},
/obj/effect/decal/cleanable/dirt,
/turf/open/floor/mineral/plastitanium,
/area/ruin/powered/golem_ship)
"eA" = (
/obj/structure/fans/tiny,
/obj/machinery/door/airlock/titanium,
/obj/effect/decal/cleanable/dirt,
/obj/effect/mapping_helpers/airlock/cyclelink_helper{
	dir = 1
	},
/turf/open/floor/plasteel/dark,
/area/ruin/powered/golem_ship)
"eF" = (
/obj/effect/turf_decal/box/corners{
	dir = 4
	},
/obj/effect/decal/cleanable/dirt,
/turf/open/floor/mineral/plastitanium,
/area/ruin/powered/golem_ship)
"eZ" = (
/turf/closed/wall/mineral/titanium/nodiagonal,
/area/space)
"fh" = (
/obj/effect/turf_decal/stripes/corner{
	dir = 8
	},
/obj/effect/decal/cleanable/dirt,
/obj/machinery/button/door{
	id = "golemloading";
	name = "Cargo Blast Door Control";
	pixel_x = -5;
	pixel_y = -24
	},
/turf/open/floor/mineral/plastitanium,
/area/ruin/powered/golem_ship)
"fJ" = (
/obj/effect/turf_decal/bot,
/obj/structure/ore_box,
/turf/open/floor/mineral/plastitanium,
/area/ruin/powered/golem_ship)
"fN" = (
/obj/effect/turf_decal/stripes,
/obj/effect/decal/cleanable/dirt,
/turf/open/floor/mineral/plastitanium,
/area/ruin/powered/golem_ship)
"gd" = (
/turf/closed/wall/mineral/plastitanium,
/area/ruin/powered/golem_ship)
"gB" = (
/obj/effect/decal/cleanable/dirt,
/obj/effect/decal/cleanable/blood/innards,
/obj/effect/decal/cleanable/blood/gibs/limb,
/turf/open/floor/mineral/titanium/blue,
/area/ruin/powered/golem_ship)
"gQ" = (
/obj/effect/spawner/structure/window/shuttle,
/turf/open/floor/plating,
/area/ruin/powered/golem_ship)
"hS" = (
/turf/open/floor/mineral/titanium/yellow,
/area/ruin/powered/golem_ship)
"jK" = (
/obj/effect/turf_decal/bot,
/obj/structure/rack,
/obj/item/pickaxe{
	pixel_x = -10
	},
/obj/item/pickaxe{
	pixel_x = -5
	},
/obj/item/pickaxe,
/obj/effect/decal/cleanable/dirt,
/turf/open/floor/mineral/plastitanium,
/area/ruin/powered/golem_ship)
"le" = (
/obj/machinery/door/airlock/titanium,
/obj/effect/mapping_helpers/airlock/cyclelink_helper{
	dir = 4
	},
/turf/open/floor/plasteel/dark,
/area/ruin/powered/golem_ship)
"lU" = (
/obj/effect/turf_decal/tile/neutral,
/obj/effect/turf_decal/tile/neutral{
	dir = 1
	},
/obj/effect/turf_decal/tile/neutral{
	dir = 8
	},
/obj/effect/decal/cleanable/dirt,
/turf/open/floor/plasteel/dark,
/area/ruin/powered/golem_ship)
"lW" = (
/obj/machinery/light{
	dir = 1
	},
/obj/item/storage/firstaid/fire{
	pixel_x = 4;
	pixel_y = 4
	},
/obj/item/storage/firstaid/fire,
/obj/item/storage/firstaid/fire{
	pixel_x = -4;
	pixel_y = -4
	},
/obj/structure/table,
/turf/open/floor/mineral/titanium/purple,
/area/ruin/powered/golem_ship)
"mL" = (
/obj/machinery/door/airlock/titanium,
/obj/effect/decal/cleanable/blood/tracks,
/turf/open/floor/plasteel/dark,
/area/ruin/powered/golem_ship)
"mT" = (
/obj/effect/decal/cleanable/dirt,
/turf/open/floor/mineral/titanium/yellow,
/area/ruin/powered/golem_ship)
"nb" = (
/obj/structure/table/reinforced,
/obj/item/clipboard,
/obj/item/toy/figure/rd{
	name = "the Liberator action figure";
	toysay = "Yeah, go do whatever."
	},
/turf/open/floor/mineral/plastitanium,
/area/ruin/powered/golem_ship)
"nA" = (
/obj/effect/turf_decal/tile/neutral{
	dir = 1
	},
/obj/effect/turf_decal/tile/neutral{
	dir = 8
	},
/obj/effect/decal/cleanable/dirt,
/turf/open/floor/plasteel/dark,
/area/ruin/powered/golem_ship)
"nW" = (
/obj/effect/turf_decal/bot,
/obj/structure/closet/crate,
/obj/item/storage/bag/ore,
/obj/item/flashlight/lantern,
/obj/item/pickaxe,
/obj/item/shovel,
/obj/item/mining_scanner,
/obj/item/card/id/mining,
/obj/effect/decal/cleanable/dirt,
/turf/open/floor/mineral/plastitanium,
/area/ruin/powered/golem_ship)
"on" = (
/obj/effect/decal/cleanable/dirt,
/obj/effect/decal/cleanable/blood/gibs/up,
/turf/open/floor/mineral/plastitanium,
/area/ruin/powered/golem_ship)
"oK" = (
/obj/effect/decal/cleanable/dirt,
/obj/effect/decal/cleanable/blood/tracks{
	dir = 10
	},
/turf/open/floor/mineral/titanium/yellow,
/area/ruin/powered/golem_ship)
"oR" = (
/obj/effect/decal/cleanable/dirt,
/obj/effect/decal/cleanable/blood/old,
/obj/effect/decal/cleanable/blood/tracks{
	dir = 5
	},
/turf/open/floor/mineral/titanium/yellow,
/area/ruin/powered/golem_ship)
"oY" = (
/obj/effect/turf_decal/bot,
/obj/structure/closet/crate,
/obj/effect/decal/cleanable/dirt,
/turf/open/floor/mineral/plastitanium,
/area/ruin/powered/golem_ship)
"pd" = (
/obj/structure/rack,
/obj/effect/turf_decal/bot,
/obj/item/resonator{
	pixel_x = 6;
	pixel_y = 6
	},
/obj/item/resonator{
	pixel_x = 2;
	pixel_y = 2
	},
/obj/item/resonator{
	pixel_x = -2;
	pixel_y = -2
	},
/obj/item/resonator{
	pixel_x = -6;
	pixel_y = -6
	},
/turf/open/floor/mineral/plastitanium,
/area/ruin/powered/golem_ship)
"pg" = (
/obj/effect/decal/cleanable/dirt,
/obj/effect/decal/cleanable/blood/tracks{
	dir = 4
	},
/turf/open/floor/mineral/titanium/yellow,
/area/ruin/powered/golem_ship)
"rG" = (
/obj/machinery/door/airlock/titanium,
/obj/structure/fans/tiny,
/obj/effect/mapping_helpers/airlock/cyclelink_helper{
	dir = 4
	},
/turf/open/floor/plasteel/dark,
/area/ruin/powered/golem_ship)
"rX" = (
/turf/open/floor/plasteel,
/area/ruin/powered/golem_ship)
"sa" = (
/obj/effect/turf_decal/tile/neutral{
	dir = 1
	},
/obj/effect/turf_decal/tile/neutral{
	dir = 4
	},
/obj/effect/turf_decal/tile/neutral{
	dir = 8
	},
/obj/effect/decal/cleanable/dirt,
/turf/open/floor/plasteel/dark,
/area/ruin/powered/golem_ship)
"si" = (
/obj/machinery/door/airlock/titanium,
/turf/open/floor/plasteel/dark,
/area/ruin/powered/golem_ship)
"sF" = (
/obj/structure/window/reinforced{
	dir = 2;
	name = "shrine of the liberator"
	},
/obj/structure/statue/gold/rd,
/turf/open/floor/plasteel/dark,
/area/ruin/powered/golem_ship)
"tT" = (
/obj/effect/decal/cleanable/dirt,
/obj/effect/decal/cleanable/blood/tracks,
/turf/open/floor/mineral/titanium/yellow,
/area/ruin/powered/golem_ship)
"uf" = (
/obj/structure/ore_box,
/obj/effect/turf_decal/bot,
/turf/open/floor/mineral/plastitanium,
/area/ruin/powered/golem_ship)
"uh" = (
/obj/structure/chair/comfy/shuttle{
	dir = 8
	},
/obj/effect/mob_spawn/human/golem/adamantine,
/obj/effect/decal/cleanable/dirt,
/turf/open/floor/mineral/plastitanium,
/area/ruin/powered/golem_ship)
"uq" = (
/obj/item/storage/firstaid/brute{
	pixel_x = 4;
	pixel_y = 4
	},
/obj/item/storage/firstaid/brute,
/obj/item/storage/firstaid/brute{
	pixel_x = -4;
	pixel_y = -4
	},
/obj/structure/table,
/turf/open/floor/mineral/titanium/purple,
/area/ruin/powered/golem_ship)
"uK" = (
/obj/effect/turf_decal/bot,
/obj/effect/turf_decal/tile/neutral,
/obj/effect/turf_decal/tile/neutral{
	dir = 4
	},
/turf/open/floor/plasteel/dark,
/area/ruin/powered/golem_ship)
"vx" = (
/obj/machinery/reagentgrinder,
/obj/structure/table,
/turf/open/floor/mineral/titanium/purple,
/area/ruin/powered/golem_ship)
"wR" = (
/obj/effect/turf_decal/tile/neutral,
/obj/effect/turf_decal/tile/neutral{
	dir = 4
	},
/obj/effect/turf_decal/tile/neutral{
	dir = 8
	},
/obj/effect/decal/cleanable/dirt,
/turf/open/floor/plasteel/dark,
/area/ruin/powered/golem_ship)
"xi" = (
/obj/item/kirbyplants{
	icon_state = "plant-22"
	},
/obj/effect/decal/cleanable/dirt,
/turf/open/floor/mineral/plastitanium,
/area/ruin/powered/golem_ship)
"xq" = (
/obj/machinery/light/small{
	dir = 1
	},
/obj/structure/extinguisher_cabinet{
	pixel_y = -30
	},
/turf/open/floor/mineral/titanium/purple,
/area/ruin/powered/golem_ship)
"yU" = (
/obj/machinery/light/small,
/obj/structure/extinguisher_cabinet{
	pixel_y = -30
	},
/obj/effect/decal/cleanable/dirt,
/turf/open/floor/mineral/titanium/purple,
/area/ruin/powered/golem_ship)
"zF" = (
/obj/effect/decal/cleanable/dirt,
/obj/effect/decal/cleanable/blood/tracks{
	dir = 4
	},
/obj/effect/decal/cleanable/blood,
/turf/open/floor/mineral/titanium/blue,
/area/ruin/powered/golem_ship)
"zL" = (
/obj/effect/decal/cleanable/dirt,
/turf/open/floor/plasteel,
/area/ruin/powered/golem_ship)
"AB" = (
/obj/item/kirbyplants{
	icon_state = "applebush"
	},
/obj/effect/decal/cleanable/dirt,
/turf/open/floor/mineral/plastitanium,
/area/ruin/powered/golem_ship)
"AS" = (
/obj/machinery/light/small,
/obj/effect/decal/cleanable/dirt,
/obj/effect/decal/cleanable/blood/tracks{
	dir = 4
	},
/turf/open/floor/mineral/titanium/blue,
/area/ruin/powered/golem_ship)
"AU" = (
/obj/effect/turf_decal/bot,
/obj/effect/turf_decal/tile/neutral,
/obj/effect/turf_decal/tile/neutral{
	dir = 4
	},
/obj/effect/decal/cleanable/dirt,
/turf/open/floor/plasteel/dark,
/area/ruin/powered/golem_ship)
"BK" = (
/obj/machinery/mineral/equipment_vendor/golem,
/turf/open/floor/mineral/plastitanium,
/area/ruin/powered/golem_ship)
"Cw" = (
/obj/machinery/computer{
	desc = "A computer long since rendered non-functional due to lack of maintenance. Spitting out error messages.";
	dir = 4;
	name = "Broken Computer"
	},
/turf/open/floor/mineral/plastitanium,
/area/ruin/powered/golem_ship)
"CX" = (
/obj/structure/table/reinforced,
/turf/open/floor/mineral/plastitanium,
/area/ruin/powered/golem_ship)
"Dv" = (
/obj/effect/turf_decal/bot,
/obj/effect/spawner/lootdrop/maintenance/three,
/obj/structure/closet/crate,
/obj/effect/decal/cleanable/dirt,
/turf/open/floor/mineral/plastitanium,
/area/ruin/powered/golem_ship)
"DC" = (
/obj/item/clothing/suit/hazardvest{
	desc = "A high-visibility lifejacket complete with whistle and slot for oxygen tanks.";
	name = "emergency lifejacket"
	},
/obj/item/clothing/suit/hazardvest{
	desc = "A high-visibility lifejacket complete with whistle and slot for oxygen tanks.";
	name = "emergency lifejacket"
	},
/obj/item/tank/internals/emergency_oxygen{
	pixel_x = 3
	},
/obj/item/tank/internals/emergency_oxygen{
	pixel_x = 3
	},
/obj/item/clothing/mask/breath{
	pixel_x = -3;
	pixel_y = -3
	},
/obj/item/clothing/mask/breath{
	pixel_x = -3;
	pixel_y = -3
	},
/obj/item/clothing/head/hardhat/orange{
	name = "protective hat";
	pixel_y = 9
	},
/obj/item/clothing/head/hardhat/orange{
	name = "protective hat";
	pixel_y = 9
	},
/obj/structure/closet/crate/internals,
/obj/effect/turf_decal/delivery,
/obj/effect/decal/cleanable/dirt,
/turf/open/floor/mineral/plastitanium,
/area/ruin/powered/golem_ship)
"DU" = (
/obj/effect/decal/cleanable/dirt,
/turf/open/floor/mineral/titanium/blue,
/area/ruin/powered/golem_ship)
"GI" = (
/obj/effect/decal/cleanable/dirt,
/obj/effect/decal/cleanable/blood/splatter,
/turf/open/floor/mineral/titanium/blue,
/area/ruin/powered/golem_ship)
"Ha" = (
/obj/structure/table/reinforced,
/obj/machinery/light/small{
	dir = 1
	},
/turf/open/floor/mineral/plastitanium,
/area/ruin/powered/golem_ship)
"HA" = (
/obj/item/areaeditor/blueprints{
	desc = "Use to build new structures in the wastes.";
	name = "land claim"
	},
/obj/item/disk/design_disk/golem_shell,
/obj/structure/table,
/turf/open/floor/mineral/titanium/purple,
/area/ruin/powered/golem_ship)
"IX" = (
/obj/item/kirbyplants{
	icon_state = "plant-21"
	},
/obj/effect/decal/cleanable/dirt,
/turf/open/floor/mineral/plastitanium,
/area/ruin/powered/golem_ship)
"Jg" = (
/obj/structure/reagent_dispensers/watertank,
/obj/effect/turf_decal/bot,
/turf/open/floor/plasteel/dark,
/area/ruin/powered/golem_ship)
"Ji" = (
/obj/structure/window/reinforced{
	dir = 8;
	name = "shrine of the liberator"
	},
/obj/structure/table/wood,
/obj/item/book/manual/wiki/research_and_development{
	name = "Sacred Text of the Liberator";
	pixel_x = -4;
	pixel_y = 3
	},
/obj/item/toy/figure/rd{
	name = "the Liberator action figure";
	toysay = "Yeah, go do whatever."
	},
/turf/open/floor/plasteel/dark,
/area/ruin/powered/golem_ship)
"JM" = (
/obj/effect/turf_decal/loading_area{
	dir = 1
	},
/obj/effect/decal/cleanable/dirt,
/turf/open/floor/mineral/plastitanium,
/area/ruin/powered/golem_ship)
"Kc" = (
/obj/machinery/door/poddoor{
	id = "golemloading"
	},
/obj/structure/fans/tiny,
/turf/open/floor/plating,
/area/ruin/powered/golem_ship)
"KM" = (
/obj/effect/decal/cleanable/blood/tracks,
/turf/open/floor/mineral/titanium/purple,
/area/ruin/powered/golem_ship)
"Ma" = (
/obj/structure/closet/crate,
/obj/effect/spawner/lootdrop/maintenance,
/turf/open/floor/mineral/titanium/yellow,
/area/ruin/powered/golem_ship)
"Md" = (
/obj/machinery/door/airlock/titanium,
/obj/effect/decal/cleanable/dirt,
/obj/effect/mapping_helpers/airlock/cyclelink_helper,
/turf/open/floor/plasteel/dark,
/area/ruin/powered/golem_ship)
"Me" = (
/obj/effect/decal/cleanable/blood/tracks{
	dir = 4
	},
/turf/open/floor/mineral/titanium/purple,
/area/ruin/powered/golem_ship)
"Mj" = (
/obj/effect/turf_decal/tile/neutral{
	dir = 8
	},
/obj/effect/turf_decal/tile/neutral,
/obj/effect/decal/cleanable/dirt,
/turf/open/floor/plasteel,
/area/ruin/powered/golem_ship)
"Mn" = (
/obj/structure/extinguisher_cabinet{
	dir = 4;
	pixel_x = 27
	},
/obj/effect/decal/cleanable/dirt,
/turf/open/floor/mineral/titanium/yellow,
/area/ruin/powered/golem_ship)
"Nj" = (
/obj/effect/decal/cleanable/dirt,
/obj/effect/decal/cleanable/blood/tracks{
	dir = 4
	},
/turf/open/floor/mineral/titanium/blue,
/area/ruin/powered/golem_ship)
"Nw" = (
/obj/structure/rack,
/obj/effect/turf_decal/bot,
/obj/item/card/id/mining,
/obj/item/card/id/mining,
/obj/item/card/id/mining,
/obj/item/card/id/mining,
/obj/item/card/id/mining,
/turf/open/floor/mineral/plastitanium,
/area/ruin/powered/golem_ship)
"Nx" = (
/obj/effect/decal/cleanable/dirt,
/turf/open/floor/mineral/plastitanium,
/area/ruin/powered/golem_ship)
"NL" = (
/obj/machinery/light/small,
/obj/effect/decal/cleanable/dirt,
/turf/open/floor/mineral/titanium/yellow,
/area/ruin/powered/golem_ship)
"NQ" = (
/obj/machinery/door/airlock/titanium,
/obj/effect/decal/cleanable/blood/tracks{
	dir = 4
	},
/turf/open/floor/plasteel/dark,
/area/ruin/powered/golem_ship)
"Or" = (
/obj/structure/table/reinforced,
/obj/machinery/light/small,
/obj/machinery/button/door{
	id = "golemloading";
	name = "Cargo Blast Door Control";
	pixel_x = -5;
	pixel_y = -24
	},
/turf/open/floor/mineral/plastitanium,
/area/ruin/powered/golem_ship)
"OP" = (
/obj/effect/decal/cleanable/blood/tracks{
	dir = 6
	},
/turf/open/floor/mineral/titanium/yellow,
/area/ruin/powered/golem_ship)
"PG" = (
/obj/effect/decal/cleanable/dirt,
/obj/effect/decal/cleanable/blood/tracks{
	dir = 9
	},
/turf/open/floor/mineral/titanium/yellow,
/area/ruin/powered/golem_ship)
"PH" = (
/obj/effect/turf_decal/bot,
/obj/structure/rack,
/obj/item/shovel,
/obj/item/shovel{
	pixel_x = 5
	},
/obj/item/shovel{
	pixel_x = 10
	},
/obj/effect/decal/cleanable/dirt,
/turf/open/floor/mineral/plastitanium,
/area/ruin/powered/golem_ship)
"PN" = (
/obj/effect/turf_decal/stripes,
/obj/effect/decal/cleanable/dirt,
/obj/effect/decal/cleanable/blood/tracks,
/turf/open/floor/mineral/plastitanium,
/area/ruin/powered/golem_ship)
"QM" = (
/obj/effect/turf_decal/tile/neutral{
	dir = 1
	},
/obj/effect/turf_decal/tile/neutral{
	dir = 8
	},
/turf/open/floor/plasteel/dark,
/area/ruin/powered/golem_ship)
"Rz" = (
/obj/structure/chair/comfy/shuttle{
	dir = 4
	},
/obj/effect/mob_spawn/human/golem/adamantine,
/obj/effect/decal/cleanable/dirt,
/turf/open/floor/mineral/plastitanium,
/area/ruin/powered/golem_ship)
"RB" = (
/obj/structure/window/reinforced{
	dir = 2;
	name = "shrine of the liberator"
	},
/obj/structure/window/reinforced{
	dir = 8;
	name = "shrine of the liberator"
	},
/turf/open/floor/plasteel/dark,
/area/ruin/powered/golem_ship)
"Sf" = (
/obj/effect/turf_decal/bot,
/obj/structure/rack,
/obj/item/storage/toolbox/electrical{
	pixel_x = -3;
	pixel_y = 3
	},
/obj/item/storage/toolbox/mechanical,
/obj/item/storage/toolbox/emergency{
	pixel_x = 3;
	pixel_y = -3
	},
/obj/effect/turf_decal/tile/neutral,
/obj/effect/turf_decal/tile/neutral{
	dir = 4
	},
/turf/open/floor/plasteel/dark,
/area/ruin/powered/golem_ship)
"Sh" = (
/obj/effect/turf_decal/bot,
/obj/structure/rack,
/obj/item/storage/bag/ore,
/obj/item/mining_scanner,
/obj/item/storage/bag/ore,
/obj/item/mining_scanner,
/obj/item/storage/bag/ore,
/obj/item/mining_scanner,
/obj/item/storage/bag/ore,
/obj/item/mining_scanner,
/obj/effect/decal/cleanable/dirt,
/turf/open/floor/mineral/plastitanium,
/area/ruin/powered/golem_ship)
"SK" = (
/obj/machinery/light,
/turf/open/floor/mineral/titanium/purple,
/area/ruin/powered/golem_ship)
"SM" = (
/obj/machinery/light/small{
	dir = 1
	},
/obj/machinery/computer/arcade/battle,
/turf/open/floor/mineral/titanium/purple,
/area/ruin/powered/golem_ship)
"SP" = (
/obj/machinery/door/airlock/titanium,
/obj/structure/fans/tiny,
/obj/effect/mapping_helpers/airlock/cyclelink_helper{
	dir = 8
	},
/turf/open/floor/plasteel/dark,
/area/ruin/powered/golem_ship)
"TE" = (
/obj/effect/turf_decal/bot,
/obj/structure/closet/crate,
/obj/item/storage/bag/ore,
/obj/item/flashlight/lantern,
/obj/item/pickaxe,
/obj/item/shovel,
/obj/item/mining_scanner,
/obj/item/card/id/mining,
/turf/open/floor/mineral/plastitanium,
/area/ruin/powered/golem_ship)
"TN" = (
/obj/structure/closet/crate/science,
/obj/item/storage/box/stockparts/basic,
/obj/item/storage/box/stockparts/basic,
/obj/effect/turf_decal/stripes,
/obj/effect/decal/cleanable/dirt,
/turf/open/floor/mineral/plastitanium,
/area/ruin/powered/golem_ship)
"Ul" = (
/obj/effect/decal/cleanable/blood/tracks{
	dir = 5
	},
/turf/open/floor/mineral/titanium/purple,
/area/ruin/powered/golem_ship)
"Va" = (
/obj/effect/turf_decal/tile/neutral{
	dir = 4
	},
/obj/effect/turf_decal/tile/neutral{
	dir = 1
	},
/obj/effect/decal/cleanable/dirt,
/turf/open/floor/plasteel,
/area/ruin/powered/golem_ship)
"Vp" = (
/obj/effect/turf_decal/bot,
/obj/effect/decal/cleanable/dirt,
/turf/open/floor/mineral/plastitanium,
/area/ruin/powered/golem_ship)
"VF" = (
/obj/structure/extinguisher_cabinet{
	pixel_y = -30
	},
/obj/effect/decal/cleanable/dirt,
/turf/open/floor/mineral/titanium/yellow,
/area/ruin/powered/golem_ship)
"Wb" = (
/obj/machinery/computer/shuttle{
	dir = 4
	},
/obj/effect/decal/cleanable/dirt,
/turf/open/floor/mineral/plastitanium,
/area/ruin/powered/golem_ship)
"XS" = (
/turf/open/floor/mineral/plastitanium,
/area/ruin/powered/golem_ship)
"Ya" = (
/obj/machinery/door/airlock/titanium,
/obj/structure/fans/tiny,
/turf/open/floor/plasteel/dark,
/area/ruin/powered/golem_ship)
"YJ" = (
/obj/machinery/mineral/ore_redemption{
	input_dir = 2;
	output_dir = 1
	},
/obj/machinery/door/firedoor,
/turf/open/floor/plasteel/dark,
/area/ruin/powered/golem_ship)
"Zf" = (
/obj/effect/decal/cleanable/dirt,
/turf/open/floor/mineral/titanium/purple,
/area/ruin/powered/golem_ship)
"Zp" = (
/obj/structure/closet/crate,
/obj/effect/spawner/lootdrop/maintenance/two,
/obj/effect/turf_decal/stripes,
/turf/open/floor/mineral/plastitanium,
/area/ruin/powered/golem_ship)
"ZY" = (
/obj/effect/turf_decal/tile/neutral,
/obj/effect/turf_decal/tile/neutral{
	dir = 1
	},
/obj/effect/turf_decal/tile/neutral{
	dir = 4
	},
/turf/open/floor/plasteel/dark,
/area/ruin/powered/golem_ship)

(1,1,1) = {"
aa
aa
aa
aa
aa
aa
gQ
gQ
gQ
gQ
gQ
gQ
aa
aa
aa
aa
aa
aa
"}
(2,1,1) = {"
aa
aa
aa
aa
aa
aa
gQ
CX
Cw
Wb
CX
gQ
aa
aa
aa
aa
aa
aa
"}
(3,1,1) = {"
aa
aa
aa
ab
Ya
ab
ab
Ha
cW
cW
Or
ab
rG
rG
ab
aa
aa
aa
"}
(4,1,1) = {"
aa
aa
aa
ab
xq
ab
xi
Nx
DU
DU
IX
ab
mT
VF
ab
aa
aa
aa
"}
(5,1,1) = {"
aa
aa
aa
ab
si
ab
ab
DU
on
Nx
GI
ab
mT
NL
ab
aa
aa
aa
"}
(6,1,1) = {"
ab
ab
ab
ab
al
al
ab
DU
Rz
Rz
gB
ab
bN
bN
ab
ab
ab
ab
"}
(7,1,1) = {"
ab
af
af
si
al
al
ab
DU
nb
CX
zF
ab
XS
hS
hS
hS
Zp
Kc
"}
(8,1,1) = {"
ab
af
af
si
al
al
ab
bH
CX
CX
AS
ab
XS
mT
Ma
hS
fN
Kc
"}
(9,1,1) = {"
ab
af
ai
ab
SM
al
ab
DU
uh
uh
Nj
ab
XS
PG
oK
mT
fN
Kc
"}
(10,1,1) = {"
ab
af
af
ab
ay
al
ab
DU
AB
xi
Nj
ab
DC
cZ
oR
tT
PN
Kc
"}
(11,1,1) = {"
ab
af
af
ab
ab
si
ab
si
ab
ab
NQ
ab
ab
pg
mT
mT
TN
Kc
"}
(12,1,1) = {"
ab
af
ai
ab
al
al
aO
al
al
al
Me
aO
ab
pg
ec
XS
fh
ab
"}
(13,1,1) = {"
ab
af
af
si
al
al
al
al
al
al
Ul
KM
mL
OP
XS
am
Vp
gQ
"}
(14,1,1) = {"
ab
af
af
si
al
al
al
al
al
al
al
al
si
hS
Nx
Vp
Vp
gQ
"}
(15,1,1) = {"
ab
af
af
ab
al
al
al
al
al
al
al
al
ab
hS
eF
Dv
oY
ab
"}
(16,1,1) = {"
aT
af
ai
ab
ab
al
al
al
al
al
al
al
ab
si
ab
ab
ab
eZ
"}
(17,1,1) = {"
aT
af
af
af
ab
Ji
RB
al
al
al
al
al
ab
Nx
mT
Md
mT
eA
"}
(18,1,1) = {"
ab
af
af
af
ab
aK
sF
al
al
al
al
al
ab
Nx
mT
Md
Mn
eA
"}
(19,1,1) = {"
ab
af
af
af
ab
ab
ab
al
al
al
al
al
YJ
JM
mT
ab
ab
ab
"}
(20,1,1) = {"
ab
af
af
af
af
ab
aw
al
al
al
al
al
ab
Nx
mT
hS
BK
ab
"}
(21,1,1) = {"
ab
af
af
af
af
ab
lW
av
al
al
al
al
si
Nx
mT
hS
TE
gQ
"}
(22,1,1) = {"
ab
af
af
af
af
ab
uq
al
al
al
al
al
ab
Nw
mT
mT
nW
gQ
"}
(23,1,1) = {"
ab
af
af
af
af
ab
vx
HA
al
al
al
SK
ab
pd
mT
mT
nW
ab
"}
(24,1,1) = {"
ab
af
af
af
ab
ab
ab
ab
bW
bW
ab
ab
ab
ab
mT
mT
Sh
gQ
"}
(25,1,1) = {"
ab
af
af
af
ab
Sf
AU
wR
Mj
Va
ZY
uK
uK
ab
mT
mT
PH
gQ
"}
(26,1,1) = {"
ab
af
af
af
si
rX
zL
zL
Mj
Va
zL
zL
zL
si
hS
hS
jK
ab
"}
(27,1,1) = {"
ab
ab
af
af
ab
QM
nA
lU
Mj
Va
sa
QM
nA
ab
fJ
fJ
ab
ab
"}
(28,1,1) = {"
aa
ab
af
af
ab
ag
Jg
ab
le
le
ab
Jg
ag
ab
uf
fJ
ab
aa
"}
(29,1,1) = {"
aa
gd
ak
ak
gd
ak
ak
ab
Zf
yU
ab
ak
ak
gd
ak
ak
gd
aa
"}
(30,1,1) = {"
aa
gd
an
an
gd
an
an
ab
SP
SP
ab
an
an
gd
an
an
gd
aa
"}
